#####################################
#...................................#
#.....##########################....#
#...................................#
#...................................#
#.....##########.....##########.....#
#..............#....................#
#.....######## #....................#
#..............#.....##########.....#
#...................................#
#####################################